# Hight_Glider,Terrain_API,AGL,lon,lat,E,N,index,timestamp
1923,1915,8,8.026550,46.376067,2645233.950,1136246.280,1,92314
1926,1915,11,8.026583,46.376033,2645236.510,1136242.520,21,92334
1900,1827,73,8.027017,46.374517,2645271.170,1136074.250,41,92354
1870,1785,85,8.025533,46.372983,2645158.260,1135902.870,61,92414
1866,1808,58,8.024567,46.371383,2645085.260,1135724.460,81,92434
1864,1815,49,8.023433,46.369833,2644999.290,1135551.500,101,92454
1875,1808,67,8.022167,46.368633,2644902.860,1135417.390,121,92514
1854,1763,91,8.022983,46.368383,2644965.860,1135390.060,141,92534
1847,1758,89,8.023533,46.368767,2645007.870,1135433.060,161,92554
1828,1750,78,8.023983,46.368833,2645042.440,1135440.660,181,92614
1816,1770,46,8.022450,46.367533,2644925.550,1135295.270,201,92634
1816,1783,33,8.022283,46.366000,2644913.960,1135124.760,221,92654
1806,1768,38,8.022550,46.364250,2644935.960,1134930.380,241,92714
1801,1725,76,8.022367,46.362550,2644923.280,1134741.300,261,92734
1811,1754,57,8.022033,46.362517,2644897.600,1134737.440,281,92754
1824,1740,84,8.022183,46.362550,2644909.120,1134741.200,301,92814
1842,1754,88,8.021833,46.362483,2644882.240,1134733.550,321,92834
1856,1770,86,8.021867,46.362917,2644884.500,1134781.810,341,92854
1864,1745,119,8.022267,46.362833,2644915.350,1134772.700,361,92914
1883,1728,155,8.022617,46.362783,2644942.330,1134767.340,381,92934
1897,1754,143,8.021833,46.362467,2644882.250,1134731.770,401,92954
1896,1759,137,8.021550,46.362350,2644860.570,1134718.600,421,93014
1902,1791,111,8.021267,46.363000,2644838.250,1134790.700,441,93034
1904,1820,84,8.020917,46.363767,2644810.690,1134875.760,461,93054
1907,1826,81,8.021267,46.365317,2644836.340,1135048.260,481,93114
1907,1845,62,8.021033,46.367017,2644816.930,1135237.100,501,93134
1895,1847,48,8.021650,46.368783,2644862.960,1135433.760,521,93154
1903,1836,67,8.023133,46.370117,2644975.970,1135582.900,541,93214
1916,1843,73,8.022617,46.369767,2644936.550,1135543.700,561,93234
1925,1874,51,8.021967,46.369883,2644886.440,1135556.220,581,93254
1942,1865,77,8.022267,46.370133,2644909.320,1135584.190,601,93314
1969,1891,78,8.022017,46.370633,2644889.670,1135639.620,621,93334
1983,1891,92,8.021950,46.370567,2644884.570,1135632.250,641,93354
1983,1923,60,8.021117,46.370433,2644820.580,1135616.880,661,93414
1985,1921,64,8.021350,46.370950,2644838.080,1135674.480,681,93434
1985,1891,94,8.022000,46.370483,2644888.480,1135622.940,701,93454
1963,1901,62,8.021167,46.369950,2644824.830,1135563.210,721,93514
1936,1897,39,8.020533,46.368283,2644777.420,1135377.550,741,93534
1936,1892,44,8.020383,46.366650,2644767.220,1135195.930,761,93554
1929,1894,35,8.020050,46.364900,2644743.030,1135001.210,781,93614
1941,1856,85,8.019383,46.363250,2644693.060,1134817.410,801,93634
1966,1856,110,8.019567,46.363217,2644707.250,1134813.850,821,93654
1999,1856,143,8.019433,46.363350,2644696.830,1134828.560,841,93714
2035,1881,154,8.018817,46.363333,2644649.430,1134826.320,861,93734
2074,1915,159,8.018150,46.363450,2644598.010,1134838.940,881,93754
2103,1971,132,8.017150,46.363433,2644521.060,1134836.490,901,93814
2139,1984,155,8.016917,46.363417,2644503.150,1134834.580,921,93834
2147,1985,162,8.017617,46.363783,2644556.720,1134875.660,941,93854
2144,2010,134,8.017967,46.365450,2644582.280,1135061.160,961,93914
2125,2044,81,8.018000,46.367500,2644583.140,1135289.060,981,93934
2143,2045,98,8.018067,46.367917,2644587.960,1135335.460,1001,93954
2167,2072,95,8.017500,46.368417,2644543.920,1135390.720,1021,94014
2201,2064,137,8.017667,46.368667,2644556.560,1135418.600,1041,94034
2221,2099,122,8.017050,46.368700,2644509.060,1135421.920,1061,94054
2250,2104,146,8.016850,46.368983,2644493.430,1135453.270,1081,94114
2279,2113,166,8.016933,46.369317,2644499.550,1135490.440,1101,94134
2293,2097,196,8.017150,46.369133,2644516.400,1135470.110,1121,94154
2299,2092,207,8.017300,46.369800,2644527.390,1135544.340,1141,94214
2314,2002,312,8.019133,46.370383,2644667.960,1135610.190,1161,94234
2334,2002,332,8.019183,46.370350,2644671.830,1135606.550,1181,94254
2350,1992,358,8.019267,46.369967,2644678.610,1135564.020,1201,94314
2370,2021,349,8.018717,46.369633,2644636.570,1135526.580,1221,94334
2357,1955,402,8.019983,46.370150,2644733.560,1135584.770,1241,94354
2307,1850,457,8.023267,46.371167,2644985.410,1135699.700,1261,94414
2265,1746,519,8.026517,46.372367,2645234.490,1135834.960,1281,94434
2231,1748,483,8.029783,46.373500,2645484.840,1135962.790,1301,94454
2181,1796,385,8.031883,46.375267,2645644.930,1136160.440,1321,94514
2149,1860,289,8.033467,46.376967,2645765.380,1136350.330,1341,94534
2132,1884,248,8.035133,46.378217,2645892.500,1136490.260,1361,94554
2103,1855,248,8.037450,46.379017,2646070.080,1136580.540,1381,94614
2095,1843,252,8.040017,46.379450,2646267.200,1136630.190,1401,94634
2091,1895,196,8.041683,46.379683,2646395.180,1136657.070,1421,94654
2096,1896,200,8.043833,46.380033,2646560.290,1136697.250,1441,94714
2091,1877,214,8.046117,46.380517,2646735.590,1136752.410,1461,94734
2103,1882,221,8.046467,46.380933,2646762.150,1136798.860,1481,94754
2118,1893,225,8.046517,46.381183,2646765.790,1136826.680,1501,94814
2123,1902,221,8.048567,46.382233,2646922.590,1136944.620,1521,94834
2102,1917,185,8.050983,46.383217,2647107.600,1137055.450,1541,94854
2065,1937,128,8.053733,46.384117,2647318.370,1137157.150,1561,94914
2064,1911,153,8.055850,46.384483,2647480.900,1137199.120,1581,94934
2051,1863,188,8.058200,46.384783,2647661.420,1137233.890,1601,94954
2034,1836,198,8.060883,46.385533,2647867.150,1137318.890,1621,95014
2028,1774,254,8.063717,46.386017,2648084.730,1137374.420,1641,95034
1999,1783,216,8.066533,46.386583,2648300.850,1137439.070,1661,95054
2008,1854,154,8.068750,46.387233,2648470.810,1137512.690,1681,95114
2042,1873,169,8.068483,46.387433,2648450.090,1137534.760,1701,95134
2075,1894,181,8.067967,46.387917,2648409.970,1137588.240,1721,95154
2095,1863,232,8.067917,46.387483,2648406.510,1137539.970,1741,95214
2124,1867,257,8.068400,46.387383,2648443.750,1137529.150,1761,95234
2118,1840,278,8.067750,46.387267,2648393.860,1137515.850,1781,95254
2097,1900,197,8.070000,46.387667,2648566.570,1137561.710,1801,95314
2065,1930,135,8.072700,46.388750,2648773.290,1137683.770,1821,95334
2078,1933,145,8.074633,46.389683,2648921.140,1137788.690,1841,95354
2049,1934,115,8.077350,46.390767,2649129.150,1137910.880,1861,95414
2072,1934,138,8.077350,46.390733,2649129.180,1137907.100,1881,95434
2092,1961,131,8.077283,46.391283,2649123.530,1137968.200,1901,95454
2121,1961,160,8.077300,46.391450,2649124.690,1137986.770,1921,95514
2162,1979,183,8.077767,46.392050,2649160.060,1138053.760,1941,95534
2187,1994,193,8.077200,46.391950,2649116.540,1138042.290,1961,95554
2220,2033,187,8.076367,46.392250,2649052.200,1138075.120,1981,95614
2252,2046,206,8.076417,46.392500,2649055.820,1138102.940,2001,95634
2292,2040,252,8.076233,46.392167,2649041.970,1138065.810,2021,95654
2311,2050,261,8.076183,46.392417,2649037.900,1138093.570,2041,95714
2325,2050,275,8.076050,46.392367,2649027.710,1138087.930,2061,95734
2347,2050,297,8.077117,46.392983,2649109.230,1138157.070,2081,95754
2357,2071,286,8.076683,46.392983,2649075.840,1138156.800,2101,95814
2375,2105,270,8.075867,46.393500,2649012.620,1138213.760,2121,95834
2400,2100,300,8.076667,46.393533,2649074.120,1138217.930,2141,95854
2384,2087,297,8.078967,46.394517,2649250.130,1138328.750,2161,95914
2402,2157,245,8.080883,46.395717,2649396.400,1138463.350,2181,95934
2430,2157,273,8.080433,46.395700,2649361.810,1138461.170,2201,95954
2457,2157,300,8.080550,46.395767,2649370.740,1138468.700,2221,100014
2468,2143,325,8.082633,46.396300,2649530.460,1138529.260,2241,100034
2438,2135,303,8.084800,46.397817,2649695.740,1138699.260,2261,100054
2414,2077,337,8.087083,46.398967,2649870.260,1138828.540,2281,100114
2407,1981,426,8.089567,46.400183,2650060.180,1138965.290,2301,100134
2415,2041,374,8.091633,46.401167,2650218.150,1139076.000,2321,100154
2417,2081,336,8.093700,46.402067,2650376.280,1139177.370,2341,100214
2365,2071,294,8.095850,46.403317,2650540.450,1139317.700,2361,100234
2357,2081,276,8.098567,46.404050,2650748.700,1139400.930,2381,100254
2342,2079,263,8.100800,46.405067,2650919.470,1139515.430,2401,100314
2323,2074,249,8.102900,46.406217,2651079.870,1139644.630,2421,100334
2309,2026,283,8.104700,46.407633,2651216.950,1139803.210,2441,100354
2281,2050,231,8.106483,46.409450,2651352.330,1140006.350,2461,100414
2248,1997,251,8.108650,46.411300,2651517.200,1140213.420,2481,100434
2262,2074,188,8.109717,46.412933,2651597.680,1140395.640,2501,100454
2299,2087,212,8.109633,46.413367,2651590.810,1140443.830,2521,100514
2322,2104,218,8.109300,46.413650,2651564.940,1140475.070,2541,100534
2362,2104,258,8.109067,46.413517,2651547.150,1140460.140,2561,100554
2391,2133,258,8.108483,46.414183,2651501.620,1140533.790,2581,100614
2421,2127,294,8.108283,46.413933,2651486.480,1140505.860,2601,100634
2445,2133,312,8.108667,46.414033,2651515.910,1140517.230,2621,100654
2437,2106,331,8.106983,46.413383,2651387.050,1140443.870,2641,100714
2462,2127,335,8.106317,46.413617,2651335.630,1140469.450,2661,100734
2469,2121,348,8.107633,46.413517,2651436.900,1140459.200,2681,100754
2408,2109,299,8.109933,46.414733,2651612.580,1140595.880,2701,100814
2367,2080,287,8.111883,46.416583,2651760.740,1140802.810,2721,100834
2334,2007,327,8.113517,46.418533,2651884.500,1141020.650,2741,100854
2300,1967,333,8.115367,46.420583,2652024.760,1141249.750,2761,100914
2276,1968,308,8.116967,46.422733,2652145.700,1141489.810,2781,100934
2259,2069,190,8.118167,46.424800,2652235.950,1141720.380,2801,100954
2290,2090,200,8.118050,46.425233,2652226.540,1141768.430,2821,101014
2331,2114,217,8.117683,46.425850,2652197.740,1141836.780,2841,101034
2379,2150,229,8.116850,46.425967,2652133.600,1141849.230,2861,101054
2430,2169,261,8.116667,46.425983,2652119.520,1141850.890,2881,101114
2469,2169,300,8.116650,46.426000,2652118.190,1141852.770,2901,101134
2493,2178,315,8.116267,46.426017,2652088.740,1141854.400,2921,101154
2524,2169,355,8.116550,46.426117,2652110.390,1141865.700,2941,101214
2546,2179,367,8.116700,46.426417,2652121.640,1141899.150,2961,101234
2555,2125,430,8.117783,46.426200,2652205.090,1141875.750,2981,101254
2522,2016,506,8.120967,46.425983,2652450.050,1141853.750,3001,101314
2478,1883,595,8.124017,46.425783,2652684.690,1141833.560,3021,101334
2433,1795,638,8.127317,46.425950,2652938.190,1141854.340,3041,101354
2398,1628,770,8.130883,46.426333,2653211.920,1141899.330,3061,101414
2376,1454,922,8.133683,46.426267,2653427.210,1141893.890,3081,101434
2345,1281,1064,8.136783,46.426150,2653665.620,1141883.000,3101,101454
2312,1130,1182,8.140167,46.426317,2653925.570,1141903.890,3121,101514
2288,1141,1147,8.143333,46.426767,2654168.480,1141956.090,3141,101534
2260,1201,1059,8.146383,46.427267,2654402.420,1142013.780,3161,101554
2237,1326,911,8.149000,46.427717,2654603.130,1142065.620,3181,101614
2209,1390,819,8.151667,46.428167,2654807.670,1142117.500,3201,101634
2182,1462,720,8.153933,46.428917,2654981.090,1142202.450,3221,101654
2134,1532,602,8.156883,46.429150,2655207.600,1142230.420,3241,101714
2123,1608,515,8.159783,46.429650,2655429.990,1142288.050,3261,101734
2137,1653,484,8.161883,46.430300,2655590.730,1142361.790,3281,101754
2146,1694,452,8.164133,46.431183,2655762.760,1142461.540,3301,101814
2161,1738,423,8.166000,46.431967,2655905.450,1142550.010,3321,101834
2167,1779,388,8.167883,46.433067,2656049.040,1142673.630,3341,101854
2150,1802,348,8.169717,46.434250,2656188.770,1142806.450,3361,101914
2142,1837,305,8.171617,46.435617,2656333.380,1142959.760,3381,101934
2115,1861,254,8.173383,46.436817,2656467.850,1143094.430,3401,101954
2104,1873,231,8.174700,46.438183,2656567.640,1143247.220,3421,102014
2096,1885,211,8.176133,46.439683,2656676.200,1143414.990,3441,102034
2078,1890,188,8.177400,46.441283,2656771.890,1143593.760,3461,102054
2116,1918,198,8.177200,46.442000,2656755.780,1143673.320,3481,102114
2148,1910,238,8.177050,46.441783,2656744.480,1143649.090,3501,102134
2176,1945,231,8.176183,46.442200,2656677.420,1143694.820,3521,102154
2218,1929,289,8.176300,46.441883,2656686.740,1143659.670,3541,102214
2240,1939,301,8.176750,46.442800,2656720.360,1143761.930,3561,102234
2201,1902,299,8.178617,46.444683,2656861.850,1143972.590,3581,102254
2194,1971,223,8.179950,46.446517,2656962.360,1144177.420,3601,102314
2199,2006,193,8.181067,46.447817,2657046.820,1144322.740,3621,102334
2190,2009,181,8.182583,46.449100,2657161.950,1144466.470,3641,102354
2209,1893,316,8.184150,46.450300,2657281.080,1144601.000,3661,102414
2173,1841,332,8.186417,46.451783,2657453.690,1144767.510,3681,102434
2174,1944,230,8.188017,46.452517,2657575.840,1144850.270,3701,102454
2200,1994,206,8.188233,46.452967,2657591.960,1144900.450,3721,102514
2197,2034,163,8.190117,46.454117,2657735.480,1145029.670,3741,102534
2197,1957,240,8.191900,46.455400,2657871.090,1145173.600,3761,102554
2162,1801,361,8.194100,46.456883,2658038.520,1145340.080,3781,102614
2143,1942,201,8.196150,46.458350,2658194.440,1145504.670,3801,102634
2150,1962,188,8.198200,46.459583,2658350.590,1145643.250,3821,102654
2165,1931,234,8.199617,46.459717,2658459.300,1145659.200,3841,102714
2189,1931,258,8.199750,46.459700,2658469.540,1145657.410,3861,102734
2205,1772,433,8.201817,46.460867,2658627.060,1145788.670,3881,102754
2174,1628,546,8.204183,46.462200,2658807.360,1145938.620,3901,102814
2141,1705,436,8.206517,46.463600,2658985.130,1146095.990,3921,102834
2106,1855,251,8.209133,46.464917,2659184.640,1146244.360,3941,102854
2132,1940,192,8.209967,46.466117,2659247.390,1146378.380,3961,102914
2175,1945,230,8.209817,46.466350,2659235.610,1146404.170,3981,102934
2220,1934,286,8.209833,46.466083,2659237.130,1146374.500,4001,102954
2254,1925,329,8.210300,46.465950,2659273.150,1146360.070,4021,103014
2300,1893,407,8.209650,46.465517,2659223.690,1146311.450,4041,103034
2353,1893,460,8.209667,46.465650,2659224.850,1146326.240,4061,103054
2408,1872,536,8.209100,46.465217,2659181.770,1146277.680,4081,103114
2450,1853,597,8.208983,46.465083,2659172.930,1146262.700,4101,103134
2493,1859,634,8.208617,46.465383,2659144.490,1146295.770,4121,103154
2531,1888,643,8.209033,46.465550,2659176.260,1146314.650,4141,103214
2538,1965,573,8.211200,46.466267,2659341.930,1146395.990,4161,103234
2489,1842,647,8.213567,46.467683,2659522.180,1146555.180,4181,103254
2456,1815,641,8.215733,46.469267,2659686.810,1146732.900,4201,103314
2451,1920,531,8.217583,46.470533,2659827.500,1146875.040,4221,103334
2439,1929,510,8.219450,46.471483,2659969.840,1146982.070,4241,103354
2386,1874,512,8.222167,46.472900,2660176.940,1147141.660,4261,103414
2357,1734,623,8.224267,46.474767,2660336.140,1147350.810,4281,103434
2323,1776,547,8.226183,46.476667,2660481.170,1147563.480,4301,103454
2333,1889,444,8.227733,46.478317,2660598.360,1147748.090,4321,103514
2377,1903,474,8.227483,46.478533,2660578.920,1147771.910,4341,103534
2379,1996,383,8.229367,46.479333,2660722.700,1147862.290,4361,103554
2338,1988,350,8.231183,46.480633,2660860.690,1148008.210,4381,103614
2284,1906,378,8.233317,46.481817,2661023.220,1148141.480,4401,103634
2292,1867,425,8.235533,46.482933,2661192.130,1148267.260,4421,103654
2337,1927,410,8.237000,46.483500,2661304.130,1148331.430,4441,103714
2334,1920,414,8.238583,46.484217,2661424.870,1148412.370,4461,103734
2305,1918,387,8.240600,46.485633,2661578.130,1148571.350,4481,103754
2259,1950,309,8.242767,46.487167,2661742.770,1148743.570,4501,103814
2256,2002,254,8.244567,46.488450,2661879.510,1148887.610,4521,103834
2299,2001,298,8.246017,46.489250,2661989.920,1148977.680,4541,103854
2334,1965,369,8.247700,46.490000,2662118.280,1149062.380,4561,103914
2288,1862,426,8.250617,46.491517,2662340.490,1149233.320,4581,103934
2250,1606,644,8.253200,46.493367,2662536.660,1149441.020,4601,103954
2211,1616,595,8.256000,46.495050,2662749.670,1149630.330,4621,104014
2182,1814,368,8.258567,46.496617,2662944.920,1149806.580,4641,104034
2167,1826,341,8.260550,46.497583,2663096.020,1149915.550,4661,104054
2148,1729,419,8.263083,46.498583,2663289.300,1150028.750,4681,104114
2168,1842,326,8.264900,46.499683,2663427.490,1150152.490,4701,104134
2168,1983,185,8.266533,46.500917,2663551.390,1150290.980,4721,104154
2200,2032,168,8.268150,46.502033,2663674.200,1150416.340,4741,104214
2261,2048,213,8.268100,46.502400,2663669.930,1150457.100,4761,104234
2328,2032,296,8.268083,46.502033,2663669.060,1150416.290,4781,104254
2402,2015,387,8.268250,46.501950,2663681.980,1150407.200,4801,104314
2459,2053,406,8.267717,46.502217,2663640.750,1150436.450,4821,104334
2525,2057,468,8.266717,46.502117,2663564.110,1150424.520,4841,104354
2535,1899,636,8.264500,46.500900,2663395.360,1150287.450,4861,104414
2496,1827,669,8.261317,46.499867,2663152.240,1150170.050,4881,104434
2421,1899,522,8.258183,46.497950,2662913.890,1149954.440,4901,104454
2411,1694,717,8.255933,46.496317,2662743.060,1149771.120,4921,104514
2368,1600,768,8.253150,46.494517,2662531.500,1149568.810,4941,104534
2328,1821,507,8.251017,46.492300,2662370.300,1149320.670,4961,104554
2293,1939,354,8.248617,46.490467,2662188.150,1149115.010,4981,104614
2308,1988,320,8.246383,46.489150,2662018.140,1148966.850,5001,104634
2337,1970,367,8.243817,46.487800,2661822.670,1148814.760,5021,104654
2345,1927,418,8.241333,46.486367,2661633.580,1148653.520,5041,104714
2313,1927,386,8.239100,46.484850,2661463.850,1148483.140,5061,104734
2332,1878,454,8.236383,46.483300,2661256.980,1148308.710,5081,104754
2330,1905,425,8.233683,46.482317,2661050.770,1148197.340,5101,104814
2286,1989,297,8.231033,46.481017,2660848.740,1148050.780,5121,104834
2280,2008,272,8.228733,46.479700,2660673.600,1147902.600,5141,104854
2330,1987,343,8.228133,46.479750,2660627.470,1147907.690,5161,104914
2335,1904,431,8.226133,46.478467,2660475.320,1147763.530,5181,104934
2290,1765,525,8.223750,46.476900,2660294.070,1147587.510,5201,104954
2262,1841,421,8.221433,46.475533,2660117.650,1147433.780,5221,105014
2225,1975,250,8.219883,46.473967,2660000.350,1147258.520,5241,105034
2225,2017,208,8.217983,46.472533,2659856.010,1147097.660,5261,105054
2264,2027,237,8.215500,46.471700,2659666.230,1147003.180,5281,105114
2242,1964,278,8.213050,46.470367,2659479.530,1146853.140,5301,105134
2201,2035,166,8.210783,46.468383,2659307.590,1146630.880,5321,105154
2221,1937,284,8.208967,46.466800,2659169.830,1146453.550,5341,105214
2234,1804,430,8.206733,46.465433,2658999.730,1146299.910,5361,105234
2197,1654,543,8.204300,46.463983,2658814.420,1146136.900,5381,105254
2167,1714,453,8.201917,46.462367,2658633.120,1145955.490,5401,105314
2141,1919,222,8.199583,46.460817,2658455.500,1145781.450,5421,105334
2128,1973,155,8.197233,46.459200,2658276.720,1145599.950,5441,105354
2180,1923,257,8.196000,46.458033,2658183.250,1145469.320,5461,105414
2206,1802,404,8.194350,46.457133,2658057.460,1145368.050,5481,105434
2162,1961,201,8.192000,46.455583,2657878.580,1145194.020,5501,105454
2140,2037,103,8.189533,46.453817,2657690.930,1144995.890,5521,105514
2159,1930,229,8.187317,46.452433,2657522.150,1144840.420,5541,105534
2144,1806,338,8.185667,46.451117,2657396.770,1144692.930,5561,105554
2123,1959,164,8.183467,46.449667,2657229.270,1144530.140,5581,105614
2119,2007,112,8.181617,46.448383,2657088.480,1144386.060,5601,105634
2122,2042,80,8.179367,46.447167,2656916.880,1144249.260,5621,105654
2159,2070,89,8.178583,46.447217,2656856.580,1144254.250,5641,105714
2190,2090,100,8.177817,46.447217,2656797.730,1144253.690,5661,105734
2171,2031,140,8.175933,46.446067,2656654.170,1144124.500,5681,105754
2160,2078,82,8.174017,46.444650,2656508.420,1143965.600,5701,105814
2131,2089,42,8.171883,46.443333,2656345.810,1143817.670,5721,105834
2114,2027,87,8.171083,46.441050,2656286.700,1143563.320,5741,105854
2145,2000,145,8.170083,46.439517,2656211.450,1143392.190,5761,105914
2186,2009,177,8.169433,46.439467,2656161.550,1143386.170,5781,105934
2229,2014,215,8.168600,46.439433,2656097.570,1143381.790,5801,105954
2267,2018,249,8.167967,46.439483,2656048.870,1143386.900,5821,110014
2297,2023,274,8.166967,46.439800,2655971.700,1143421.420,5841,110034
2335,2041,294,8.166817,46.440333,2655959.620,1143480.560,5861,110054
2370,2035,335,8.165900,46.440183,2655889.300,1143463.240,5881,110114
2401,2057,344,8.165800,46.440767,2655881.020,1143528.080,5901,110134
2430,2046,384,8.165167,46.440467,2655832.680,1143494.280,5921,110154
2454,2046,408,8.165233,46.440617,2655837.600,1143511.010,5941,110214
2481,2031,450,8.164133,46.439967,2655753.740,1143437.970,5961,110234
2510,2024,486,8.162350,46.439633,2655617.060,1143399.580,5981,110254
2502,1932,570,8.159700,46.438733,2655414.330,1143297.660,6001,110314
2445,1790,655,8.156333,46.437617,2655156.720,1143171.230,6021,110334
2404,1671,733,8.152783,46.436483,2654885.040,1143042.690,6041,110354
2356,1570,786,8.149117,46.435233,2654604.560,1142901.180,6061,110414
2301,1458,843,8.145750,46.433650,2654347.380,1142722.880,6081,110434
2258,1298,960,8.142683,46.431733,2654113.570,1142507.660,6101,110454
2232,1200,1032,8.139517,46.429817,2653872.130,1142292.500,6121,110514
2220,1212,1008,8.137200,46.428317,2653695.530,1142124.170,6141,110534
2209,1365,844,8.134750,46.426983,2653508.530,1141974.210,6161,110554
2193,1538,655,8.132467,46.425600,2653334.400,1141818.920,6181,110614
2167,1655,512,8.130067,46.424317,2653151.170,1141674.680,6201,110634
2167,1687,480,8.127750,46.422950,2652974.400,1141521.150,6221,110654
2148,1657,491,8.125317,46.421450,2652788.830,1141352.770,6241,110714
2107,1595,512,8.123333,46.419767,2652637.940,1141164.360,6261,110734
2069,1733,336,8.121250,46.418233,2652479.290,1140992.440,6281,110754
2045,1844,201,8.119250,46.416667,2652327.040,1140817.030,6301,110814
2052,1900,152,8.117383,46.415167,2652184.950,1140649.050,6321,110834
2067,1945,122,8.115833,46.413867,2652067.030,1140503.510,6341,110854
2107,1963,144,8.115083,46.413617,2652009.600,1140475.220,6361,110914
2154,1955,199,8.115250,46.413650,2652022.410,1140479.000,6381,110934
2208,2009,199,8.113067,46.413483,2651854.730,1140458.990,6401,110954
2253,2045,208,8.111083,46.412967,2651702.680,1140400.320,6421,111014
2272,2017,255,8.109050,46.411917,2651547.370,1140282.270,6441,111034
2248,2055,193,8.107083,46.410550,2651397.420,1140129.020,6461,111054
2237,2052,185,8.105217,46.408817,2651255.580,1139935.160,6481,111114
2248,2069,179,8.103667,46.407283,2651137.840,1139763.630,6501,111134
2237,2111,126,8.101633,46.406050,2650982.600,1139625.240,6521,111154
2223,2120,103,8.099283,46.404900,2650802.970,1139495.880,6541,111214
2254,2097,157,8.097483,46.404133,2650665.270,1139409.460,6561,111234
2259,2097,162,8.095017,46.403300,2650476.410,1139315.270,6581,111254
2274,2106,168,8.093033,46.402350,2650324.720,1139208.400,6601,111314
2252,2045,207,8.090717,46.400983,2650147.880,1139054.960,6621,111334
2239,2006,233,8.088433,46.399667,2649973.440,1138907.210,6641,111354
2220,2096,124,8.086300,46.398367,2649810.600,1138761.350,6661,111414
2189,2095,94,8.084150,46.396683,2649646.780,1138572.790,6681,111434
2207,2110,97,8.082217,46.395250,2649499.420,1138412.280,6701,111454
2194,2048,146,8.079933,46.394017,2649324.880,1138273.780,6721,111514
2199,2050,149,8.077350,46.393000,2649127.130,1138159.110,6741,111534
2183,2037,146,8.075300,46.391700,2648970.630,1138013.310,6761,111554
2234,2035,199,8.074650,46.391483,2648920.830,1137988.790,6781,111614
2233,2006,227,8.072300,46.390750,2648740.730,1137905.840,6801,111634
2216,1961,255,8.069167,46.390067,2648500.360,1137827.980,6821,111654
2247,1905,342,8.066933,46.389500,2648329.020,1137763.580,6841,111714
2233,1868,365,8.064283,46.389050,2648125.580,1137711.920,6861,111734
2191,1907,284,8.061383,46.388200,2647903.260,1137615.660,6881,111754
2172,1928,244,8.058350,46.387267,2647670.780,1137510.100,6901,111814
2202,1975,227,8.056050,46.386817,2647494.250,1137458.690,6921,111834
2209,2006,203,8.053983,46.386367,2647335.640,1137407.420,6941,111854
2220,2018,202,8.051817,46.385567,2647169.720,1137317.180,6961,111914
2236,2052,184,8.049517,46.384600,2646993.630,1137208.310,6981,111934
2270,2040,230,8.047150,46.383767,2646812.260,1137114.300,7001,111954
2279,1971,308,8.044500,46.383183,2646608.900,1137047.800,7021,112014
2265,1925,340,8.041767,46.382383,2646399.330,1136957.260,7041,112034
2252,1890,362,8.039100,46.381467,2646194.940,1136853.860,7061,112054
2224,1897,327,8.036400,46.380283,2645988.230,1136720.660,7081,112114
2226,1915,311,8.034050,46.379350,2645808.220,1136615.570,7101,112134
2241,1921,320,8.031933,46.378583,2645646.000,1136529.080,7121,112154
2205,1903,302,8.029417,46.377250,2645453.540,1136379.440,7141,112214
2165,1904,261,8.026683,46.375833,2645244.370,1136220.340,7161,112234
2122,1845,277,8.024400,46.374283,2645070.010,1136046.730,7181,112254
2088,1907,181,8.022233,46.372500,2644904.750,1135847.290,7201,112314
2116,1915,201,8.021533,46.371133,2644852.010,1135694.930,7221,112334
2130,1985,145,8.019883,46.370833,2644725.300,1135660.640,7241,112354
2107,1998,109,8.018783,46.369083,2644642.100,1135465.480,7261,112414
2109,2024,85,8.018200,46.367300,2644598.700,1135266.950,7281,112434
2087,2024,63,8.017450,46.365333,2644542.590,1135047.860,7301,112454
2092,1971,121,8.017467,46.363583,2644545.340,1134853.340,7321,112514
2092,2022,70,8.016517,46.363767,2644472.080,1134873.260,7341,112534
2096,2049,47,8.015600,46.363550,2644401.690,1134848.610,7361,112554
2107,2018,89,8.014667,46.361967,2644331.180,1134672.120,7381,112614
2090,2024,66,8.013017,46.360383,2644205.480,1134495.110,7401,112634
2106,2029,77,8.012350,46.360117,2644154.360,1134465.160,7421,112654
2119,2023,96,8.013200,46.360450,2644219.510,1134502.660,7441,112714
2093,2012,81,8.011933,46.359183,2644123.030,1134361.100,7461,112734
2101,1981,120,8.010933,46.357600,2644047.350,1134184.570,7481,112754
2127,1967,160,8.010933,46.357250,2644047.630,1134145.660,7501,112814
2161,1981,180,8.010900,46.357617,2644044.790,1134186.440,7521,112834
2208,1987,221,8.010033,46.357217,2643978.390,1134141.490,7541,112854
2248,1975,273,8.010167,46.357333,2643988.610,1134154.460,7561,112914
2292,1995,297,8.009417,46.357250,2643930.950,1134144.820,7581,112934
2328,1980,348,8.009683,46.356867,2643951.730,1134102.390,7601,112954
2364,1970,394,8.009900,46.356917,2643968.390,1134108.070,7621,113014
2388,1995,393,8.009450,46.357217,2643933.520,1134141.170,7641,113034
2409,1994,415,8.009017,46.357133,2643900.260,1134131.590,7661,113054
2401,1994,407,8.009117,46.357117,2643907.970,1134129.860,7681,113114
2431,1976,455,8.008400,46.356417,2643853.350,1134051.650,7701,113134
2455,1955,500,8.007667,46.355567,2643797.620,1133956.750,7721,113154
2465,1954,511,8.007217,46.355733,2643762.850,1133974.950,7741,113214
2502,1941,561,8.006933,46.355350,2643741.300,1133932.220,7761,113234
2526,1909,617,8.006217,46.355083,2643686.400,1133902.140,7781,113254
2548,1876,672,8.005533,46.354617,2643634.130,1133849.960,7801,113314
2561,1815,746,8.004383,46.354200,2643545.950,1133802.970,7821,113334
2565,1767,798,8.003333,46.353733,2643465.500,1133750.470,7841,113354
2568,1725,843,8.002450,46.353000,2643398.120,1133668.500,7861,113414
2559,1731,828,8.002500,46.352367,2643402.480,1133598.160,7881,113434
2531,1374,1157,7.998750,46.351767,2643114.300,1133529.400,7901,113454
2503,1358,1145,7.994617,46.351217,2642796.600,1133466.000,7921,113514
2476,1113,1363,7.991133,46.349750,2642529.570,1133301.030,7941,113534
2415,1248,1167,7.986750,46.348800,2642192.920,1133193.060,7961,113554
2380,1099,1281,7.983367,46.347433,2641933.560,1133039.290,7981,113614
2341,1244,1097,7.979500,46.346133,2641636.870,1132892.720,8001,113634
2321,1407,914,7.975917,46.344767,2641362.080,1132738.980,8021,113654
2298,1627,671,7.972967,46.343183,2641136.180,1132561.350,8041,113714
2265,1793,472,7.969883,46.341567,2640899.970,1132380.100,8061,113734
2247,1955,292,7.966833,46.340033,2640666.300,1132208.000,8081,113754
2233,1984,249,7.964167,46.338717,2640462.020,1132060.330,8101,113814
2190,2043,147,7.961317,46.337267,2640243.670,1131897.680,8121,113834
2208,2047,161,7.959300,46.335667,2640089.550,1131718.790,8141,113854
2237,2056,181,7.958800,46.335533,2640051.150,1131703.640,8161,113914
2268,2068,200,7.958633,46.335633,2640038.210,1131714.670,8181,113934
2284,2056,228,7.958917,46.335417,2640060.240,1131690.800,8201,113954
2306,1983,323,7.958933,46.334500,2640062.150,1131588.870,8221,114014
2328,1988,340,7.958133,46.334300,2640000.700,1131566.230,8241,114034
2325,1975,350,7.957683,46.333867,2639966.360,1131517.870,8261,114054
2319,1940,379,7.957367,46.333383,2639942.390,1131463.910,8281,114114
2309,2026,283,7.954750,46.333517,2639740.780,1131477.470,8301,114134
2302,2109,193,7.952783,46.334517,2639588.590,1131587.640,8321,114154
2347,2100,247,7.951767,46.334383,2639510.460,1131572.240,8341,114214
2396,2085,311,7.951467,46.334500,2639487.280,1131585.090,8361,114234
2445,2051,394,7.951217,46.334700,2639467.880,1131607.200,8381,114254
2472,1997,475,7.950133,46.335200,2639384.050,1131662.240,8401,114314
2513,1962,551,7.949783,46.334867,2639357.350,1131625.040,8421,114334
2536,1923,613,7.949150,46.334850,2639308.620,1131622.840,8441,114354
2559,1911,648,7.948783,46.334750,2639280.430,1131611.540,8461,114414
2591,1897,694,7.948483,46.334783,2639257.310,1131615.060,8481,114434
2601,1732,869,7.945567,46.334700,2639032.840,1131604.380,8501,114454
2546,1438,1108,7.941350,46.334283,2638708.440,1131555.930,8521,114514
2513,1725,788,7.937550,46.333700,2638416.250,1131489.260,8541,114534
2471,1914,557,7.933683,46.332817,2638119.110,1131389.220,8561,114554
2468,2170,298,7.930567,46.331883,2637879.830,1131283.890,8581,114614
2462,2198,264,7.929483,46.332367,2637796.020,1131337.170,8601,114634
2408,2194,214,7.925850,46.332067,2637516.480,1131302.080,8621,114654
2395,2210,185,7.922433,46.332100,2637253.340,1131304.120,8641,114714
2370,2197,173,7.918900,46.332167,2636981.250,1131309.900,8661,114734
2361,2158,203,7.915533,46.332300,2636721.890,1131323.100,8681,114754
2349,2137,212,7.912167,46.332317,2636462.690,1131323.420,8701,114814
2350,2098,252,7.909233,46.332150,2636236.880,1131303.500,8721,114834
2325,2142,183,7.906417,46.331550,2636020.440,1131235.510,8741,114854
2333,2153,180,7.903967,46.330833,2635832.250,1131154.680,8761,114914
2351,2126,225,7.901967,46.330083,2635678.740,1131070.400,8781,114934
2382,2107,275,7.901433,46.329550,2635637.960,1131010.910,8801,114954
2418,2118,300,7.901433,46.329600,2635637.930,1131016.470,8821,115014
2441,2125,316,7.900850,46.329683,2635592.980,1131025.430,8841,115034
2451,2158,293,7.899067,46.329933,2635455.520,1131052.410,8861,115054
2470,2156,314,7.898883,46.330100,2635441.240,1131070.890,8881,115114
2517,2123,394,7.898433,46.329300,2635407.110,1130981.760,8901,115134
2580,2146,434,7.899000,46.329767,2635450.470,1131033.930,8921,115154
2616,2150,466,7.898000,46.330233,2635373.160,1131085.280,8941,115214
2654,2151,503,7.897417,46.330783,2635327.910,1131146.160,8961,115234
2643,1908,735,7.894067,46.331150,2635069.710,1131185.450,8981,115254
2616,1922,694,7.890733,46.332433,2634812.160,1131326.590,9001,115314
2617,1751,866,7.887717,46.332633,2634579.790,1131347.490,9021,115334
2527,1619,908,7.884750,46.332967,2634351.120,1131383.320,9041,115354
2439,1418,1021,7.882500,46.333017,2634177.830,1131387.900,9061,115414
2421,1225,1196,7.879050,46.332767,2633912.330,1131358.610,9081,115434
2399,1462,937,7.875867,46.332900,2633667.160,1131372.030,9101,115454
2359,1648,711,7.872717,46.333183,2633424.430,1131402.140,9121,115514
2326,1841,485,7.869750,46.333533,2633195.750,1131439.790,9141,115534
2343,1992,351,7.867050,46.334017,2632987.560,1131492.460,9161,115554
2358,1992,366,7.866917,46.334000,2632977.330,1131490.510,9181,115614
2391,2042,349,7.865883,46.334483,2632897.420,1131543.770,9201,115634
2427,2049,378,7.865933,46.334700,2632901.140,1131567.910,9221,115654
2461,2042,419,7.865733,46.334467,2632885.880,1131541.930,9241,115714
2486,2049,437,7.865733,46.334767,2632885.700,1131575.280,9261,115734
2499,2074,425,7.865050,46.334167,2632833.470,1131508.290,9281,115754
2525,2113,412,7.863800,46.334283,2632737.150,1131520.670,9301,115814
2554,2158,396,7.862567,46.334217,2632642.250,1131512.820,9321,115834
2573,2156,417,7.861933,46.333850,2632593.650,1131471.760,9341,115854
2562,2207,355,7.859183,46.334250,2632381.660,1131515.090,9361,115914
2591,2226,365,7.858067,46.334500,2632295.580,1131542.420,9381,115934
2613,2209,404,7.857383,46.334500,2632242.920,1131542.140,9401,115954
2641,2183,458,7.856783,46.334433,2632196.760,1131534.440,9421,120014
2688,2183,505,7.856700,46.334517,2632190.310,1131543.750,9441,120034
2726,2170,556,7.856417,46.334367,2632168.610,1131526.960,9461,120054
2747,2090,657,7.854300,46.334217,2632005.690,1131509.420,9481,120114
2751,1927,824,7.851133,46.334350,2631761.760,1131522.920,9501,120134
2728,1892,836,7.847650,46.334150,2631493.680,1131499.280,9521,120154
2697,1932,765,7.843750,46.333983,2631193.480,1131479.160,9541,120214
2663,1998,665,7.840300,46.334150,2630927.740,1131496.360,9561,120234
2659,1850,809,7.837050,46.334050,2630677.540,1131483.970,9581,120254
2633,1681,952,7.834033,46.334267,2630445.110,1131506.920,9601,120314
2585,1458,1127,7.831000,46.334817,2630211.270,1131566.890,9621,120334
2534,1457,1077,7.827700,46.335550,2629956.770,1131647.110,9641,120354
2513,1628,885,7.824233,46.336200,2629689.460,1131718.050,9661,120414
2490,1733,757,7.821100,46.336800,2629447.910,1131783.570,9681,120434
2450,1808,642,7.817783,46.337167,2629192.320,1131823.130,9701,120454
2421,1981,440,7.814483,46.337550,2628938.030,1131864.490,9721,120514
2387,2032,355,7.811100,46.337617,2628677.520,1131870.690,9741,120534
2378,2107,271,7.808133,46.337550,2628449.110,1131862.170,9761,120554
2349,1852,497,7.805133,46.337533,2628218.130,1131859.200,9781,120614
2307,1725,582,7.802017,46.337750,2627978.100,1131882.210,9801,120634
2270,1862,408,7.798683,46.338017,2627721.270,1131910.710,9821,120654
2250,1935,315,7.795200,46.338183,2627453.010,1131927.940,9841,120714
2228,1901,327,7.791717,46.338050,2627184.910,1131911.940,9861,120734
2221,2052,169,7.788617,46.337950,2626946.270,1131899.760,9881,120754
2240,2096,144,7.786050,46.338017,2626748.600,1131906.330,9901,120814
2277,2087,190,7.785650,46.337900,2626717.850,1131893.190,9921,120834
2321,2114,207,7.785933,46.338283,2626739.460,1131935.860,9941,120854
2366,2147,219,7.785800,46.338867,2626728.930,1132000.730,9961,120914
2410,2183,227,7.786000,46.339500,2626744.020,1132071.170,9981,120934
2454,2218,236,7.785833,46.339867,2626730.980,1132111.910,10001,120954
2500,2236,264,7.785717,46.340317,2626721.830,1132161.890,10021,121014
2542,2277,265,7.785017,46.340617,2626667.790,1132195.000,10041,121034
2578,2293,285,7.784933,46.340933,2626661.160,1132230.100,10061,121054
2603,2331,272,7.784833,46.341417,2626653.230,1132283.870,10081,121114
2609,2390,219,7.784900,46.342267,2626657.970,1132378.380,10101,121134
2644,2351,293,7.784417,46.341633,2626621.100,1132307.740,10121,121154
2658,2366,292,7.783000,46.341833,2626511.900,1132329.500,10141,121214
2680,2389,291,7.781200,46.341383,2626373.540,1132278.870,10161,121234
2692,2454,238,7.780150,46.341900,2626292.450,1132335.990,10181,121254
2675,2392,283,7.777667,46.341450,2626101.500,1132285.140,10201,121314
2641,2307,334,7.775400,46.340250,2625927.540,1132150.990,10221,121334
2671,2310,361,7.775450,46.340383,2625931.330,1132165.790,10241,121354
2698,2330,368,7.775133,46.340450,2625906.890,1132173.130,10261,121414
2720,2336,384,7.774550,46.340500,2625861.980,1132178.500,10281,121434
2746,2356,390,7.773983,46.340717,2625818.220,1132202.440,10301,121454
2809,2339,470,7.773333,46.340450,2625768.300,1132172.540,10321,121514
2852,2352,500,7.773133,46.340883,2625752.700,1132220.610,10341,121534
2886,2316,570,7.772167,46.341400,2625678.080,1132277.770,10361,121554
2899,2068,831,7.769133,46.341633,2625444.390,1132302.680,10381,121614
2907,1832,1075,7.766083,46.341517,2625209.630,1132288.800,10401,121634
2891,1631,1260,7.763150,46.341917,2624983.630,1132332.330,10421,121654
2841,1426,1415,7.759600,46.342083,2624710.240,1132349.670,10441,121714
2810,1093,1717,7.755917,46.342400,2624426.550,1132383.750,10461,121734
2756,1052,1704,7.751733,46.342117,2624104.560,1132351.000,10481,121754
2723,1231,1492,7.747383,46.342433,2623769.520,1132384.810,10501,121814
2690,1449,1241,7.743317,46.342867,2623456.300,1132431.830,10521,121834
2663,1698,965,7.739350,46.343317,2623150.700,1132480.680,10541,121854
2641,1947,694,7.735650,46.343367,2622865.820,1132485.150,10561,121914
2619,2089,530,7.732550,46.343500,2622627.110,1132499.040,10581,121934
2607,2069,538,7.729850,46.343667,2622419.170,1132516.830,10601,121954
2597,2045,552,7.726800,46.343567,2622184.400,1132504.850,10621,122014
2583,2058,525,7.724067,46.343533,2621974.010,1132500.310,10641,122034
2540,2100,440,7.721083,46.343417,2621744.330,1132486.580,10661,122054
2506,2136,370,7.718383,46.342900,2621536.670,1132428.370,10681,122114
2516,2102,414,7.716817,46.341650,2621416.600,1132288.980,10701,122134
2515,2134,381,7.716567,46.341950,2621397.230,1132322.270,10721,122154
2542,2103,439,7.714733,46.341433,2621256.240,1132264.300,10741,122214
2559,2103,456,7.714133,46.341517,2621210.010,1132273.470,10761,122234
2569,2130,439,7.713783,46.341900,2621182.910,1132315.950,10781,122254
2575,2152,423,7.711133,46.341650,2620978.990,1132287.450,10801,122314
2580,2193,387,7.708567,46.341533,2620781.480,1132273.770,10821,122334
2605,2185,420,7.708200,46.341400,2620753.270,1132258.880,10841,122354
2623,2181,442,7.707300,46.341050,2620684.120,1132219.740,10861,122414
2625,2189,436,7.704500,46.341317,2620468.440,1132248.690,10881,122434
2594,2163,431,7.701100,46.341700,2620206.530,1132290.380,10901,122454
2583,2080,503,7.698217,46.342067,2619984.440,1132330.450,10921,122514
2540,1997,543,7.695133,46.342350,2619746.900,1132361.130,10941,122534
2521,2039,482,7.692483,46.342733,2619542.740,1132403.040,10961,122554
2518,2031,487,7.690083,46.342683,2619357.990,1132396.890,10981,122614
2498,1961,537,7.687300,46.342750,2619143.710,1132403.660,11001,122634
2462,1801,661,7.684250,46.342850,2618908.860,1132414.040,11021,122654
2422,1935,487,7.681100,46.342867,2618666.340,1132415.170,11041,122714
2390,2016,374,7.678067,46.342733,2618432.880,1132399.560,11061,122734
2372,2023,349,7.675017,46.342667,2618198.090,1132391.520,11081,122754
2374,2079,295,7.672083,46.342617,2617972.220,1132385.280,11101,122814
2349,2095,254,7.669700,46.342417,2617788.820,1132362.510,11121,122834
2334,2129,205,7.666867,46.342550,2617570.670,1132376.660,11141,122854
2384,2131,253,7.665733,46.342333,2617483.440,1132352.280,11161,122914
2431,2138,293,7.665417,46.342467,2617459.070,1132367.110,11181,122934
2474,2139,335,7.664900,46.342867,2617419.130,1132411.460,11201,122954
2507,2114,393,7.663850,46.342083,2617338.550,1132324.070,11221,123014
2550,2125,425,7.664733,46.341950,2617406.570,1132309.480,11241,123034
2614,2127,487,7.664367,46.342367,2617378.260,1132355.760,11261,123054
2673,2113,560,7.663267,46.342683,2617293.470,1132390.650,11281,123114
2715,2083,632,7.662333,46.342567,2617221.600,1132377.550,11301,123134
2739,2091,648,7.662633,46.342900,2617244.590,1132414.630,11321,123154
2755,2070,685,7.661733,46.342583,2617175.400,1132379.190,11341,123214
2765,2027,738,7.660400,46.342117,2617072.920,1132327.100,11361,123234
2754,1932,822,7.657683,46.342333,2616863.680,1132350.530,11381,123254
2718,1896,822,7.654633,46.341983,2616628.970,1132310.970,11401,123314
2679,1844,835,7.651317,46.341800,2616373.730,1132289.930,11421,123334
2639,1767,872,7.648117,46.342117,2616127.270,1132324.510,11441,123354
2608,1632,976,7.644883,46.342100,2615878.290,1132321.960,11461,123414
2581,1477,1104,7.641417,46.341817,2615611.520,1132289.810,11481,123434
2570,1401,1169,7.637800,46.341767,2615333.070,1132283.540,11501,123454
2552,1333,1219,7.634500,46.341583,2615079.050,1132262.450,11521,123514
2524,1241,1283,7.631283,46.340817,2614831.580,1132176.690,11541,123534
2505,1139,1366,7.627733,46.340717,2614558.290,1132164.910,11561,123554
2486,1049,1437,7.624400,46.340800,2614301.660,1132173.530,11581,123614
2464,1081,1383,7.621217,46.340900,2614056.570,1132184.070,11601,123634
2440,1114,1326,7.618233,46.340967,2613826.810,1132190.990,11621,123654
2420,1197,1223,7.615367,46.341167,2613606.110,1132212.720,11641,123714
2407,1309,1098,7.612517,46.341467,2613386.610,1132245.590,11661,123734
2385,1464,921,7.609700,46.341250,2613169.780,1132220.990,11681,123754
2360,1720,640,7.607017,46.341067,2612963.260,1132200.200,11701,123814
2348,1799,549,7.604567,46.340867,2612774.680,1132177.570,11721,123834
2339,1846,493,7.601833,46.340567,2612564.250,1132143.780,11741,123854
2318,1904,414,7.599133,46.340283,2612356.440,1132111.780,11761,123914
2302,1946,356,7.596433,46.339817,2612148.670,1132059.560,11781,123934
2294,2005,289,7.593967,46.339900,2611958.780,1132068.410,11801,123954
2280,1910,370,7.591483,46.340050,2611767.500,1132084.710,11821,124014
2254,1808,446,7.588750,46.340133,2611557.060,1132093.530,11841,124034
2218,1919,299,7.585733,46.340233,2611324.760,1132104.210,11861,124054
2191,1897,294,7.582783,46.340550,2611097.570,1132139.030,11881,124114
2183,1954,229,7.580133,46.340633,2610893.520,1132147.890,11901,124134
2177,2041,136,7.577833,46.340667,2610716.440,1132151.350,11921,124154
2176,2053,123,7.575700,46.340800,2610552.190,1132165.850,11941,124214
2180,2026,154,7.573300,46.341200,2610367.330,1132210.000,11961,124234
2193,2050,143,7.573333,46.341333,2610369.850,1132224.790,11981,124254
2182,2035,147,7.574067,46.341100,2610426.410,1132198.980,12001,124314
2170,2090,80,7.572433,46.342300,2610300.380,1132332.170,12021,124334
2150,2044,106,7.570200,46.342500,2610128.420,1132354.110,12041,124354
2162,1972,190,7.569500,46.341767,2610074.670,1132272.540,12061,124414
2154,2014,140,7.568400,46.342783,2609989.790,1132385.340,12081,124434
2160,1944,216,7.566867,46.342383,2609871.840,1132340.680,12101,124454
2145,1925,220,7.565083,46.341767,2609734.600,1132271.980,12121,124514
2129,1890,239,7.562717,46.341133,2609552.550,1132201.220,12141,124534
2110,1819,291,7.560483,46.340550,2609380.660,1132136.140,12161,124554
2085,1749,336,7.557800,46.340133,2609174.160,1132089.470,12181,124614
2060,1682,378,7.554783,46.339900,2608941.910,1132063.220,12201,124634
2033,1618,415,7.551767,46.339500,2608709.770,1132018.420,12221,124654
2008,1541,467,7.548683,46.339150,2608472.370,1131979.180,12241,124714
1982,1404,578,7.545783,46.338900,2608249.130,1131951.080,12261,124734
1948,1627,321,7.543017,46.338467,2608036.230,1131902.660,12281,124754
1918,1699,219,7.540317,46.338017,2607828.410,1131852.360,12301,124814
1895,1719,176,7.537717,46.337650,2607628.270,1131811.310,12321,124834
1918,1728,190,7.537883,46.337917,2607641.010,1131841.010,12341,124854
1925,1728,197,7.537867,46.338183,2607639.740,1131870.580,12361,124914
1915,1688,227,7.537650,46.336983,2607623.200,1131737.160,12381,124934
1889,1679,210,7.535450,46.336617,2607453.860,1131696.260,12401,124954
1870,1680,190,7.533067,46.336800,2607270.350,1131716.380,12421,125014
1843,1712,131,7.530550,46.337067,2607076.520,1131745.840,12441,125034
1831,1742,89,7.528317,46.336767,2606904.620,1131712.290,12461,125054
1855,1742,113,7.528367,46.336750,2606908.470,1131710.400,12481,125114
1881,1774,107,7.528467,46.337650,2606916.060,1131810.460,12501,125134
1923,1788,135,7.528067,46.337917,2606885.230,1131840.110,12521,125154
1954,1781,173,7.528183,46.337867,2606894.170,1131834.560,12541,125214
1987,1797,190,7.528567,46.338617,2606923.640,1131917.970,12561,125234
2018,1791,227,7.528217,46.338750,2606896.670,1131932.720,12581,125254
2036,1805,231,7.528700,46.338883,2606933.840,1131947.550,12601,125314
2052,1824,228,7.529183,46.339233,2606970.990,1131986.500,12621,125334
2065,1834,231,7.528583,46.339317,2606924.780,1131995.780,12641,125354
2045,1830,215,7.528017,46.339583,2606881.170,1132025.310,12661,125414
2015,1859,156,7.526083,46.339933,2606732.220,1132064.050,12681,125434
1990,1802,188,7.523350,46.339083,2606521.900,1131969.330,12701,125454
1955,1814,141,7.520717,46.338150,2606319.280,1131865.400,12721,125514
1948,1826,122,7.519750,46.337150,2606244.940,1131754.160,12741,125534
1955,1852,103,7.519033,46.337433,2606189.710,1131785.560,12761,125554
1951,1873,78,7.518450,46.337617,2606144.800,1131805.970,12781,125614
1955,1885,70,7.517917,46.337650,2606103.750,1131809.600,12801,125634
1969,1875,94,7.517783,46.337483,2606093.460,1131791.020,12821,125654
1973,1885,88,7.517950,46.337750,2606106.280,1131820.710,12841,125714
1974,1889,85,7.516817,46.337717,2606019.050,1131816.960,12861,125734
1954,1869,85,7.515333,46.336683,2605904.900,1131701.900,12881,125754
1966,1826,140,7.514867,46.335583,2605869.140,1131579.590,12901,125814
1968,1843,125,7.514767,46.335917,2605861.400,1131616.710,12921,125834
1957,1800,157,7.514100,46.334667,2605810.180,1131477.700,12941,125854
1951,1739,212,7.513233,46.333450,2605743.540,1131342.350,12961,125914
1928,1701,227,7.511750,46.332533,2605629.450,1131240.310,12981,125934
1916,1674,242,7.509450,46.331683,2605452.420,1131145.660,13001,125954
1881,1755,126,7.506433,46.331467,2605220.120,1131121.440,13021,130014
1885,1776,109,7.505633,46.331133,2605158.550,1131084.260,13041,130034
1888,1783,105,7.505633,46.331500,2605158.510,1131125.060,13061,130054
1886,1816,70,7.504250,46.331583,2605052.010,1131134.200,13081,130114
1893,1821,72,7.503700,46.331283,2605009.680,1131100.810,13101,130134
1905,1827,78,7.503200,46.331467,2604971.170,1131121.240,13121,130154
1914,1842,72,7.503183,46.331667,2604969.840,1131143.470,13141,130214
1914,1842,72,7.503017,46.331733,2604957.050,1131150.790,13161,130234
1929,1842,87,7.502583,46.331600,2604923.640,1131135.980,13181,130254
1931,1851,80,7.502850,46.331833,2604944.180,1131161.900,13201,130314
1928,1851,77,7.502650,46.332083,2604928.760,1131189.680,13221,130334
1921,1830,91,7.502683,46.331467,2604931.350,1131121.200,13241,130354
1899,1825,74,7.500933,46.330567,2604796.670,1131021.050,13261,130414
1899,1807,92,7.499833,46.329517,2604712.060,1130904.260,13281,130434
1894,1766,128,7.500383,46.329000,2604754.460,1130846.820,13301,130454
1900,1784,116,7.502300,46.330383,2604901.960,1131000.680,13321,130514
1922,1796,126,7.502117,46.330417,2604887.860,1131004.450,13341,130534
1906,1802,104,7.503133,46.330783,2604966.070,1131045.190,13361,130554
1891,1781,110,7.505350,46.331100,2605136.760,1131080.570,13381,130614
1902,1792,110,7.504633,46.331117,2605081.550,1131082.420,13401,130634
1913,1802,111,7.504817,46.332083,2605095.630,1131189.820,13421,130654
1940,1797,143,7.505300,46.332283,2605132.800,1131212.080,13441,130714
1970,1826,144,7.504733,46.332717,2605089.100,1131260.290,13461,130734
2004,1844,160,7.505050,46.333717,2605113.420,1131371.470,13481,130754
2031,1837,194,7.505250,46.333667,2605128.820,1131365.930,13501,130814
2050,1860,190,7.505200,46.334250,2605124.920,1131430.740,13521,130834
2069,1871,198,7.505183,46.334317,2605123.600,1131438.180,13541,130854
2081,1889,192,7.504683,46.334733,2605085.060,1131484.390,13561,130914
2095,1882,213,7.504417,46.334533,2605064.600,1131462.140,13581,130934
2110,1882,228,7.504400,46.334417,2605063.300,1131449.250,13601,130954
2102,1920,182,7.504533,46.335483,2605073.440,1131567.760,13621,131014
2092,1932,160,7.504700,46.335750,2605086.280,1131597.450,13641,131034
2091,1909,182,7.503533,46.334833,2604996.500,1131495.440,13661,131054
2120,1916,204,7.502967,46.334683,2604952.930,1131478.730,13681,131114
2152,1917,235,7.502700,46.334717,2604932.370,1131482.490,13701,131134
2173,1925,248,7.502967,46.334983,2604952.910,1131512.080,13721,131154
2184,1934,250,7.502817,46.335200,2604941.340,1131536.190,13741,131214
2197,1943,254,7.502767,46.335417,2604937.470,1131560.310,13761,131234
2204,1945,259,7.501783,46.335017,2604861.740,1131515.780,13781,131254
2158,1925,233,7.499950,46.334117,2604720.670,1131415.630,13801,131314
2118,1909,209,7.497817,46.332483,2604556.570,1131233.860,13821,131334
2142,1915,227,7.497417,46.332700,2604525.750,1131257.960,13841,131354
2155,1918,237,7.496850,46.332817,2604482.080,1131270.930,13861,131414
2167,1927,240,7.497050,46.332983,2604497.460,1131289.400,13881,131434
2169,1917,252,7.496050,46.332917,2604420.470,1131282.000,13901,131454
2147,1880,267,7.494317,46.331733,2604287.110,1131150.290,13921,131514
2138,1852,286,7.492017,46.330733,2604110.080,1131039.000,13941,131534
2123,1880,243,7.489817,46.329600,2603940.750,1130912.940,13961,131554
2107,1887,220,7.487617,46.328417,2603771.410,1130781.330,13981,131614
2113,1977,136,7.485650,46.327383,2603620.000,1130666.290,14001,131634
2134,1929,205,7.486267,46.327650,2603667.500,1130696.000,14021,131654
2162,1942,220,7.486100,46.328350,2603654.590,1130773.810,14041,131714
2199,1986,213,7.485600,46.328417,2603616.090,1130781.230,14061,131734
2225,2042,183,7.485250,46.328250,2603589.140,1130762.650,14081,131754
2244,2014,230,7.485167,46.328167,2603582.760,1130753.420,14101,131814
2264,2033,231,7.484700,46.328550,2603546.770,1130795.980,14121,131834
2283,2051,232,7.484067,46.328483,2603498.030,1130788.500,14141,131854
2262,2096,166,7.481367,46.327850,2603290.140,1130718.020,14161,131914
2277,2068,209,7.480267,46.327467,2603205.450,1130675.400,14181,131934
2290,2043,247,7.478267,46.327600,2603051.420,1130690.110,14201,131954
2301,2029,272,7.475800,46.327150,2602861.460,1130639.990,14221,132014
2301,2038,263,7.473400,46.326483,2602676.670,1130565.760,14241,132034
2306,2015,291,7.471050,46.325550,2602495.730,1130461.970,14261,132054
2312,2006,306,7.468733,46.324917,2602317.320,1130391.530,14281,132114
2318,2010,308,7.466617,46.324583,2602154.370,1130354.350,14301,132134
2309,2005,304,7.464400,46.323800,2601983.660,1130267.250,14321,132154
2263,1926,337,7.462033,46.323017,2601801.390,1130180.150,14341,132214
2230,1914,316,7.459517,46.321683,2601607.650,1130031.800,14361,132234
2202,1754,448,7.457233,46.320383,2601431.780,1129887.250,14381,132254
2167,1813,354,7.458533,46.319833,2601531.920,1129826.130,14401,132314
2133,1915,218,7.460600,46.321300,2601691.080,1129989.250,14421,132334
2094,1930,164,7.462650,46.322900,2601848.910,1130167.160,14441,132354
2048,1973,75,7.465583,46.323383,2602074.780,1130220.920,14461,132414
2041,1911,130,7.468383,46.323033,2602290.440,1130182.090,14481,132434
2019,1896,123,7.471350,46.323283,2602518.940,1130209.970,14501,132454
2016,1882,134,7.474183,46.323517,2602737.120,1130236.070,14521,132514
2026,1889,137,7.473917,46.323750,2602716.620,1130261.970,14541,132534
2038,1891,147,7.474383,46.324000,2602752.490,1130289.770,14561,132554
2043,1916,127,7.474150,46.324550,2602734.520,1130350.910,14581,132614
2049,1912,137,7.475433,46.324600,2602833.330,1130356.510,14601,132634
2049,1932,117,7.476117,46.325350,2602885.970,1130439.910,14621,132654
2051,1942,109,7.476850,46.325617,2602942.410,1130469.610,14641,132714
2049,1927,122,7.477133,46.325283,2602964.220,1130432.500,14661,132734
2057,1915,142,7.477383,46.324950,2602983.490,1130395.490,14681,132754
2052,1908,144,7.477283,46.324967,2602975.790,1130397.370,14701,132814
2024,1933,91,7.479717,46.325117,2603163.230,1130414.140,14721,132834
2022,1937,85,7.481967,46.325133,2603336.510,1130416.010,14741,132854
2011,1923,88,7.484467,46.325367,2603529.030,1130442.130,14761,132914
2003,1944,59,7.485933,46.326117,2603641.880,1130525.570,14781,132934
2009,1937,72,7.486367,46.325983,2603675.310,1130510.690,14801,132954
2018,1944,74,7.485933,46.326000,2603641.890,1130512.560,14821,133014
2034,1933,101,7.486000,46.325733,2603647.070,1130482.890,14841,133034
2055,1934,121,7.485950,46.325717,2603643.220,1130481.100,14861,133054
2057,1933,124,7.485983,46.325767,2603645.750,1130486.660,14881,133114
2068,1937,131,7.486517,46.326017,2603686.860,1130514.480,14901,133134
2084,1942,142,7.486333,46.326267,2603672.680,1130542.260,14921,133154
2111,1944,167,7.485717,46.326117,2603625.250,1130525.560,14941,133214
2144,1934,210,7.485717,46.325833,2603625.260,1130493.990,14961,133234
2151,1942,209,7.486067,46.326117,2603652.200,1130525.580,14981,133254
2174,1932,242,7.486617,46.326567,2603694.530,1130575.630,15001,133314
2196,1953,243,7.486417,46.327067,2603679.090,1130631.200,15021,133334
2197,1919,278,7.486967,46.327267,2603721.430,1130653.460,15041,133354
2211,1923,288,7.486733,46.327517,2603703.400,1130681.240,15061,133414
2213,1915,298,7.486950,46.327967,2603720.080,1130731.270,15081,133434
2219,1895,324,7.487250,46.328367,2603743.150,1130775.750,15101,133454
2221,1887,334,7.487550,46.328833,2603766.220,1130827.570,15121,133514
2226,1883,343,7.488050,46.328900,2603804.720,1130835.040,15141,133534
2230,1880,350,7.488233,46.329017,2603818.810,1130848.060,15161,133554
2228,1905,323,7.488600,46.329617,2603847.030,1130914.770,15181,133614
2227,1883,344,7.490833,46.331117,2604018.880,1131081.630,15201,133634
2198,1895,303,7.493700,46.332333,2604239.560,1131216.960,15221,133654
2186,1931,255,7.496350,46.333550,2604443.520,1131352.390,15241,133714
2166,1936,230,7.498750,46.333817,2604628.300,1131382.210,15261,133734
2170,1928,242,7.501250,46.334417,2604820.750,1131449.050,15281,133754
2178,1941,237,7.501950,46.334967,2604874.600,1131510.240,15301,133814
2169,1932,237,7.504833,46.335850,2605096.510,1131608.580,15321,133834
2151,1876,275,7.507200,46.336883,2605278.660,1131723.560,15341,133854
2117,1855,262,7.510100,46.337717,2605501.870,1131816.470,15361,133914
2109,1932,177,7.512517,46.338417,2605687.900,1131894.460,15381,133934
2125,1961,164,7.513117,46.338850,2605734.050,1131942.640,15401,133954
2141,1973,168,7.513450,46.339267,2605759.640,1131989.020,15421,134014
2149,1977,172,7.513733,46.339150,2605781.450,1131976.030,15441,134034
2165,1973,192,7.513217,46.339200,2605741.710,1131981.550,15461,134054
2208,1940,268,7.512483,46.338717,2605685.250,1131927.810,15481,134114
2237,1961,276,7.512917,46.338783,2605718.660,1131935.170,15501,134134
2253,1950,303,7.512850,46.338500,2605713.530,1131903.710,15521,134154
2269,1970,299,7.513517,46.338900,2605764.840,1131948.220,15541,134214
2292,1978,314,7.513217,46.339467,2605741.680,1132011.230,15561,134234
2320,1989,331,7.513817,46.339433,2605787.880,1132007.500,15581,134254
2340,1997,343,7.513750,46.340067,2605782.660,1132077.970,15601,134314
2362,2003,359,7.513833,46.339933,2605789.060,1132063.080,15621,134334
2381,2007,374,7.514200,46.340017,2605817.310,1132072.440,15641,134354
2396,2024,372,7.514767,46.340467,2605860.920,1132122.510,15661,134414
2396,2012,384,7.514183,46.340400,2605815.960,1132115.020,15681,134434
2386,2038,348,7.516533,46.341283,2605996.800,1132213.350,15701,134454
2364,1996,368,7.519983,46.341883,2606262.340,1132280.320,15721,134514
2328,1967,361,7.523517,46.342650,2606534.340,1132365.870,15741,134534
2314,2013,301,7.526717,46.343217,2606780.630,1132429.170,15761,134554
2332,1999,333,7.527567,46.343133,2606846.080,1132419.900,15781,134614
2346,1996,350,7.527917,46.343117,2606873.030,1132418.150,15801,134634
2349,1999,350,7.528200,46.343117,2606894.810,1132418.180,15821,134654
2344,1999,345,7.531150,46.343400,2607121.890,1132449.900,15841,134714
2301,1919,382,7.534767,46.343633,2607400.320,1132476.130,15861,134734
2266,1841,425,7.538150,46.343533,2607660.790,1132465.340,15881,134754
2255,1763,492,7.541483,46.343417,2607917.400,1132452.770,15901,134814
2231,1565,666,7.545067,46.343200,2608193.360,1132429.010,15921,134834
2221,1660,561,7.548567,46.343000,2608462.850,1132407.150,15941,134854
2187,1727,460,7.551900,46.342783,2608719.480,1132383.390,15961,134914
2159,1773,386,7.555317,46.342617,2608982.580,1132365.320,15981,134934
2132,1871,261,7.558633,46.342650,2609237.870,1132369.370,16001,134954
2122,1933,189,7.561883,46.343033,2609488.010,1132412.330,16021,135014
2104,1965,139,7.565050,46.343333,2609731.780,1132446.060,16041,135034
2131,1972,159,7.565700,46.343483,2609781.800,1132462.820,16061,135054
2161,1979,182,7.566200,46.344000,2609820.200,1132520.350,16081,135114
2188,1994,194,7.566017,46.344367,2609806.040,1132561.130,16101,135134
2202,1987,215,7.566117,46.344217,2609813.770,1132544.470,16121,135154
2236,1987,249,7.566050,46.344100,2609808.630,1132531.450,16141,135214
2266,1988,278,7.566383,46.344217,2609834.250,1132544.500,16161,135234
2290,1995,295,7.567317,46.344283,2609906.140,1132551.950,16181,135254
2312,2002,310,7.567083,46.344333,2609888.120,1132557.480,16201,135314
2326,2016,310,7.567383,46.344600,2609911.160,1132587.200,16221,135334
2356,2023,333,7.567600,46.344883,2609927.820,1132618.690,16241,135354
2372,2027,345,7.567883,46.345100,2609949.570,1132642.850,16261,135414
2390,2053,337,7.568467,46.345183,2609994.510,1132652.150,16281,135434
2405,2063,342,7.568600,46.345567,2610004.680,1132694.850,16301,135454
2413,2078,335,7.569050,46.345683,2610039.300,1132707.800,16321,135514
2410,2154,256,7.571383,46.344600,2610219.110,1132587.710,16341,135534
2428,2139,289,7.571767,46.343933,2610248.800,1132513.610,16361,135554
2443,2172,271,7.573350,46.344117,2610370.630,1132534.270,16381,135614
2490,2170,320,7.573967,46.343967,2610418.160,1132517.680,16401,135634
2528,2170,358,7.573883,46.343817,2610411.720,1132500.990,16421,135654
2552,2152,400,7.572633,46.343767,2610315.500,1132495.270,16441,135714
2582,2158,424,7.572683,46.343817,2610319.340,1132500.840,16461,135734
2613,2168,445,7.573183,46.344200,2610357.760,1132543.480,16481,135754
2646,2171,475,7.573033,46.344533,2610346.150,1132580.480,16501,135814
2677,2165,512,7.572567,46.344667,2610310.250,1132595.310,16521,135834
2706,2146,560,7.571700,46.344400,2610243.550,1132565.520,16541,135854
2722,2155,567,7.571800,46.344683,2610251.200,1132596.990,16561,135914
2737,2180,557,7.573767,46.344500,2610402.660,1132576.900,16581,135934
2719,2184,535,7.576433,46.344383,2610607.930,1132564.250,16601,135954
2698,2170,528,7.579167,46.344483,2610818.390,1132575.740,16621,140014
2670,2154,516,7.582017,46.344550,2611037.780,1132583.580,16641,140034
2634,2137,497,7.585017,46.344617,2611268.730,1132591.460,16661,140054
2599,2074,525,7.588033,46.344833,2611500.870,1132615.900,16681,140114
2585,2150,435,7.590817,46.345167,2611715.130,1132653.440,16701,140134
2562,2160,402,7.593567,46.345383,2611926.790,1132677.870,16721,140154
2556,2097,459,7.596000,46.345583,2612114.050,1132700.470,16741,140214
2536,1831,705,7.598717,46.345850,2612323.160,1132730.570,16761,140234
2514,1607,907,7.602000,46.346050,2612575.850,1132753.320,16781,140254
2483,1456,1027,7.605233,46.346000,2612824.750,1132748.280,16801,140314
2454,1403,1051,7.608450,46.346333,2613072.320,1132785.830,16821,140334
2421,1264,1157,7.611617,46.346600,2613316.070,1132816.040,16841,140354
2389,1154,1235,7.614833,46.346667,2613563.630,1132824.040,16861,140414
2353,1015,1338,7.618150,46.346750,2613818.960,1132833.840,16881,140434
2330,1240,1090,7.621667,46.347117,2614089.610,1132875.260,16901,140454
2309,1373,936,7.625183,46.347467,2614360.190,1132914.800,16921,140514
2289,1472,817,7.628517,46.348233,2614616.640,1133000.570,16941,140534
2273,1561,712,7.631600,46.349000,2614853.760,1133086.410,16961,140554
2244,1636,608,7.634383,46.349533,2615067.850,1133146.190,16981,140614
2201,1718,483,7.636783,46.350517,2615252.320,1133256.040,17001,140634
2158,1748,410,7.639767,46.351067,2615481.870,1133317.760,17021,140654
2132,1834,298,7.642600,46.352150,2615699.630,1133438.710,17041,140714
2127,1921,206,7.644000,46.353617,2615806.970,1133602.070,17061,140734
2118,2024,94,7.645700,46.355017,2615937.410,1133758.040,17081,140754
2146,2056,90,7.646683,46.355600,2616012.900,1133823.050,17101,140814
2183,2056,127,7.647217,46.355567,2616054.010,1133819.490,17121,140834
2192,2022,170,7.645517,46.355000,2615923.330,1133756.120,17141,140854
2216,2065,151,7.645550,46.355733,2615925.660,1133837.610,17161,140914
2237,2065,172,7.645583,46.355933,2615928.140,1133859.850,17181,140934
2264,2058,206,7.644967,46.355817,2615880.760,1133846.830,17201,140954
2294,2067,227,7.645117,46.356067,2615892.230,1133874.650,17221,141014
2319,2086,233,7.645617,46.356417,2615930.610,1133913.660,17241,141034
2340,2086,254,7.645483,46.356250,2615920.350,1133895.070,17261,141054
2366,2107,259,7.646250,46.356533,2615979.300,1133926.680,17281,141114
2403,2090,313,7.645833,46.356517,2615947.210,1133924.820,17301,141134
2438,2107,331,7.646283,46.356583,2615981.830,1133932.250,17321,141154
2480,2085,395,7.646267,46.356200,2615980.710,1133889.670,17341,141214
2511,2079,432,7.645817,46.356233,2615946.060,1133893.240,17361,141234
2539,2076,463,7.645550,46.356033,2615925.570,1133870.960,17381,141254
2543,2070,473,7.646733,46.355883,2616016.670,1133854.520,17401,141314
2517,2031,486,7.649283,46.354867,2616213.240,1133742.100,17421,141334
2483,1980,503,7.651933,46.353567,2616417.610,1133598.140,17441,141354
2444,1959,485,7.654050,46.351783,2616581.100,1133400.260,17461,141414
2390,1964,426,7.656317,46.350150,2616756.110,1133219.210,17481,141434
2356,2045,311,7.658633,46.348517,2616934.900,1133038.170,17501,141454
2332,2119,213,7.660950,46.346883,2617113.770,1132857.030,17521,141514
2313,2159,154,7.663950,46.345667,2617345.100,1132722.510,17541,141534
2298,2203,95,7.667100,46.344900,2617587.850,1132637.950,17561,141554
2307,2194,113,7.669817,46.344850,2617797.040,1132633.000,17581,141614
2325,2158,167,7.671850,46.344900,2617953.530,1132639.020,17601,141634
2347,2123,224,7.674100,46.344833,2618126.770,1132632.090,17621,141654
2327,2094,233,7.677200,46.344517,2618365.530,1132597.680,17641,141714
2292,1997,295,7.680617,46.344250,2618628.680,1132568.800,17661,141734
2267,1824,443,7.684117,46.343900,2618898.260,1132530.730,17681,141754
2237,2015,222,7.687750,46.343667,2619178.030,1132505.700,17701,141814
2214,2062,152,7.691100,46.343233,2619436.090,1132458.280,17721,141834
2218,2065,153,7.694267,46.342917,2619680.020,1132423.940,17741,141854
2204,2016,188,7.696933,46.342267,2619885.510,1132352.350,17761,141914
2186,2119,67,7.699117,46.341667,2620053.870,1132286.210,17781,141934
2170,2100,70,7.701317,46.340633,2620223.640,1132171.830,17801,141954
2154,2103,51,7.703250,46.339317,2620372.950,1132026.030,17821,142014
2125,2071,54,7.706367,46.338650,2620613.190,1131952.700,17841,142034
2137,2045,92,7.709183,46.338750,2620829.970,1131964.560,17861,142054
2130,2055,75,7.711400,46.339650,2621000.320,1132065.190,17881,142114
2104,2033,71,7.714083,46.340283,2621206.640,1132136.280,17901,142134
2070,1974,96,7.716900,46.339817,2621423.710,1132085.240,17921,142154
2068,1967,101,7.718467,46.340100,2621544.240,1132117.130,17941,142214
2060,1920,140,7.718583,46.338933,2621553.640,1131987.430,17961,142234
2026,1905,121,7.721800,46.338750,2621801.400,1131967.980,17981,142254
1999,1886,113,7.725300,46.338750,2622070.880,1131968.950,18001,142314
1987,1866,121,7.728167,46.338567,2622291.690,1131949.420,18021,142334
1974,1878,96,7.729750,46.337267,2622414.110,1131805.350,18041,142354
1946,1887,59,7.732067,46.336367,2622592.880,1131705.970,18061,142414
1913,1738,175,7.735600,46.336267,2622864.950,1131695.870,18081,142434
1868,1562,306,7.738900,46.336050,2623119.140,1131672.720,18101,142454
1824,1339,485,7.742600,46.335600,2623404.220,1131623.790,18121,142514
1800,1139,661,7.746083,46.335433,2623672.480,1131606.260,18141,142534
1775,946,829,7.749400,46.335300,2623927.940,1131592.480,18161,142554
1749,892,857,7.752750,46.335283,2624185.890,1131591.620,18181,142614
1722,1163,559,7.756200,46.335383,2624451.490,1131603.800,18201,142634
1706,1473,233,7.759533,46.335483,2624708.080,1131615.960,18221,142654
1708,1604,104,7.761550,46.336000,2624863.150,1131674.070,18241,142714
1722,1583,139,7.761667,46.336267,2624872.040,1131703.790,18261,142734
1738,1619,119,7.761833,46.336167,2624884.860,1131692.720,18281,142754
1757,1619,138,7.761983,46.336067,2624896.460,1131681.650,18301,142814
1773,1637,136,7.762167,46.336183,2624910.570,1131694.610,18321,142834
1787,1619,168,7.761900,46.336233,2624889.990,1131700.080,18341,142854
1788,1619,169,7.762050,46.336233,2624901.540,1131700.130,18361,142914
1791,1671,120,7.762233,46.335933,2624915.770,1131666.840,18381,142934
1785,1627,158,7.761600,46.335700,2624867.140,1131640.730,18401,142954
1782,1618,164,7.762467,46.336417,2624933.570,1131720.710,18421,143014
1804,1603,201,7.762367,46.336600,2624925.780,1131741.030,18441,143034
1817,1606,211,7.762133,46.336517,2624907.800,1131731.720,18461,143054
1820,1603,217,7.762483,46.336583,2624934.720,1131739.170,18481,143114
1811,1639,172,7.763017,46.337100,2624975.600,1131796.810,18501,143134
1802,1718,84,7.763700,46.338667,2625027.470,1131971.220,18521,143154
1802,1706,96,7.763450,46.339200,2625007.980,1132030.400,18541,143214
1801,1729,72,7.764567,46.337767,2625094.640,1131871.450,18561,143234
1769,1660,109,7.763100,46.336450,2624982.290,1131724.580,18581,143254
1749,1683,66,7.762200,46.335083,2624913.620,1131572.340,18601,143314
1747,1616,131,7.762867,46.333617,2624965.650,1131409.580,18621,143334
1725,1642,83,7.762383,46.332000,2624929.120,1131229.670,18641,143354
1702,1642,60,7.761333,46.330467,2624848.970,1131058.930,18661,143414
1682,1583,99,7.761467,46.329267,2624859.830,1130925.570,18681,143434
1663,1569,94,7.764300,46.329600,2625077.840,1130963.490,18701,143454
1659,1582,77,7.767350,46.329967,2625312.540,1131005.270,18721,143514
1649,1606,43,7.770283,46.330150,2625538.310,1131026.560,18741,143534
1646,1589,57,7.773000,46.330167,2625747.530,1131029.330,18761,143554
1632,1572,60,7.775683,46.329900,2625954.260,1131000.530,18781,143614
1640,1542,98,7.777733,46.329167,2626112.480,1130919.730,18801,143634
1641,1555,86,7.778450,46.329283,2626167.630,1130932.860,18821,143654
1640,1576,64,7.777967,46.329617,2626130.280,1130969.830,18841,143714
1628,1566,62,7.777500,46.329600,2626094.330,1130967.790,18861,143734
1620,1551,69,7.780050,46.329033,2626290.970,1130905.610,18881,143754
1612,1565,47,7.782667,46.328350,2626492.830,1130830.560,18901,143814
1595,1560,35,7.785550,46.327433,2626715.290,1130729.600,18921,143834
1551,1483,68,7.789017,46.326650,2626982.670,1130643.740,18941,143854
1514,1230,284,7.793050,46.326033,2627293.560,1130576.540,18961,143914
1495,1322,173,7.796583,46.325767,2627565.780,1130548.210,18981,143934
1495,1413,82,7.798700,46.324700,2627729.360,1130430.340,19001,143954
1490,1441,49,7.798883,46.324967,2627743.310,1130460.090,19021,144014
1491,1447,44,7.799383,46.324367,2627782.130,1130393.560,19041,144034
1483,1403,80,7.799217,46.323883,2627769.590,1130339.700,19061,144054
1452,1316,136,7.802583,46.323917,2628028.800,1130344.680,19081,144114
1391,1195,196,7.805883,46.322817,2628283.520,1130223.580,19101,144134
1366,1146,220,7.809083,46.321267,2628530.780,1130052.430,19121,144154
1351,993,358,7.811867,46.320267,2628745.730,1129942.280,19141,144214
1333,984,349,7.814633,46.319450,2628959.200,1129852.480,19161,144234
1325,1251,74,7.817450,46.319133,2629176.340,1129818.280,19181,144254
1299,1227,72,7.820467,46.319133,2629408.710,1129819.400,19201,144314
1247,1100,147,7.823867,46.318467,2629670.950,1129746.650,19221,144334
1223,1050,173,7.827450,46.317700,2629947.340,1129662.740,19241,144354
1195,1007,188,7.830550,46.317117,2630186.430,1129599.120,19261,144414
1197,1124,73,7.833667,46.316650,2630426.780,1129548.410,19281,144434
1200,1136,64,7.833967,46.316850,2630449.770,1129570.760,19301,144454
1204,1131,73,7.833533,46.317317,2630416.080,1129622.500,19321,144514
1206,1145,61,7.833983,46.317483,2630450.650,1129641.130,19341,144534
1206,1141,65,7.834083,46.316900,2630458.680,1129576.360,19361,144554
1206,1135,71,7.834300,46.316533,2630475.600,1129535.650,19381,144614
1203,1139,64,7.837617,46.315883,2630731.460,1129464.680,19401,144634
1204,1122,82,7.840750,46.315367,2630973.070,1129408.550,19421,144654
1172,1078,94,7.844067,46.314800,2631228.890,1129346.840,19441,144714
1150,1043,107,7.847867,46.314167,2631521.960,1129277.990,19461,144734
1113,989,124,7.851283,46.313817,2631785.290,1129240.460,19481,144754
1074,910,164,7.855133,46.313033,2632082.320,1129154.870,19501,144814
1059,832,227,7.858800,46.312433,2632365.140,1129089.670,19521,144834
1030,740,290,7.861700,46.310917,2632589.440,1128922.350,19541,144854
1022,654,368,7.864583,46.309100,2632812.620,1128721.560,19561,144914
1026,717,309,7.869133,46.308450,2633163.520,1128651.220,19581,144934
1037,779,258,7.871133,46.308517,2633317.550,1128659.510,19601,144954
1061,811,250,7.872283,46.308833,2633405.950,1128695.130,19621,145014
1065,811,254,7.872300,46.308783,2633407.290,1128689.580,19641,145034
1095,835,260,7.872450,46.308683,2633418.910,1128678.520,19661,145054
1111,847,264,7.872750,46.308733,2633441.990,1128684.210,19681,145114
1118,847,271,7.872833,46.308650,2633448.430,1128675.020,19701,145134
1117,929,188,7.874867,46.308383,2633605.290,1128646.210,19721,145154
1136,949,187,7.875867,46.309067,2633681.900,1128722.670,19741,145214
1146,963,183,7.876050,46.309350,2633695.820,1128754.210,19761,145234
1149,969,180,7.876367,46.309683,2633720.040,1128791.360,19781,145254
1160,972,188,7.876650,46.309850,2633741.730,1128810.050,19801,145314
1164,992,172,7.877817,46.309633,2633831.770,1128786.430,19821,145334
1172,993,179,7.878883,46.309233,2633914.130,1128742.420,19841,145354
1183,1017,166,7.878917,46.309600,2633916.530,1128783.230,19861,145414
1183,1038,145,7.879667,46.310700,2633973.610,1128905.840,19881,145434
1192,1052,140,7.879983,46.310383,2633998.150,1128870.730,19901,145454
1198,1059,139,7.880350,46.310400,2634026.420,1128872.780,19921,145514
1212,1051,161,7.881233,46.310983,2634094.070,1128937.970,19941,145534
1224,1059,165,7.881733,46.311317,2634132.380,1128975.320,19961,145554
1241,1069,172,7.882333,46.311683,2634178.370,1129016.270,19981,145614
1249,1114,135,7.883267,46.311767,2634250.260,1129026.010,20001,145634
1265,1114,151,7.883250,46.311567,2634249.080,1129003.770,20021,145654
1287,1146,141,7.884317,46.311767,2634331.140,1129026.470,20041,145714
1307,1160,147,7.885233,46.312567,2634401.200,1129115.800,20061,145734
1322,1189,133,7.885817,46.313000,2634445.910,1129164.190,20081,145754
1348,1185,163,7.885833,46.312683,2634447.340,1129128.960,20101,145814
1365,1224,141,7.886567,46.313817,2634503.160,1129255.340,20121,145834
1373,1269,104,7.887933,46.313717,2634608.450,1129244.820,20141,145854
1406,1263,143,7.887750,46.313417,2634594.540,1129211.390,20161,145914
1418,1290,128,7.888667,46.314017,2634664.800,1129278.500,20181,145934
1440,1296,144,7.888833,46.314167,2634677.490,1129295.240,20201,145954
1458,1303,155,7.889017,46.313733,2634691.940,1129247.080,20221,150014
1467,1303,164,7.889033,46.314450,2634692.710,1129326.790,20241,150034
1483,1290,193,7.888617,46.313783,2634661.090,1129252.460,20261,150054
1487,1277,210,7.888400,46.313933,2634644.280,1129269.040,20281,150114
1476,1354,122,7.890750,46.313650,2634825.480,1129238.620,20301,150134
1481,1375,106,7.891950,46.313517,2634918.000,1129224.370,20321,150154
1464,1355,109,7.895533,46.312933,2635194.370,1129161.050,20341,150214
1437,1314,123,7.899583,46.312400,2635506.690,1129103.620,20361,150234
1412,1234,178,7.903033,46.311750,2635772.870,1129032.930,20381,150254
1386,1262,124,7.906350,46.310800,2636029.010,1128928.840,20401,150314
1364,1286,78,7.910200,46.309933,2636326.160,1128834.240,20421,150334
1329,1203,126,7.913283,46.308717,2636564.480,1128700.490,20441,150354
1311,1223,88,7.916450,46.307417,2636809.330,1128557.460,20461,150414
1288,1066,222,7.920083,46.306167,2637090.050,1128420.210,20481,150434
1231,982,249,7.924333,46.305600,2637417.860,1128359.200,20501,150454
1196,910,286,7.928767,46.305200,2637759.730,1128316.860,20521,150514
1166,801,365,7.932917,46.304950,2638079.620,1128291.070,20541,150534
1142,714,428,7.937367,46.305133,2638422.320,1128313.580,20561,150554
1127,666,461,7.941917,46.305617,2638772.510,1128369.620,20581,150614
1102,662,440,7.946300,46.306333,2639109.660,1128451.380,20601,150634
1067,660,407,7.950633,46.307483,2639442.640,1128581.390,20621,150654
1036,660,376,7.955150,46.308750,2639789.690,1128724.510,20641,150714
1003,660,343,7.959533,46.309867,2640126.510,1128850.910,20661,150734
966,663,303,7.963817,46.311033,2640455.650,1128982.720,20681,150754
924,665,259,7.967967,46.311967,2640774.630,1129088.690,20701,150814
914,664,250,7.971967,46.313000,2641081.980,1129205.610,20721,150834
909,664,245,7.972050,46.313317,2641088.130,1129240.890,20741,150854
870,666,204,7.972233,46.313467,2641102.110,1129257.660,20761,150914
814,667,147,7.972367,46.313317,2641112.550,1129241.060,20781,150934
774,666,108,7.972300,46.313400,2641107.320,1129250.250,20801,150954
723,665,58,7.975700,46.314850,2641368.120,1129413.220,20821,151014
707,666,41,7.975283,46.315267,2641335.680,1129459.350,20841,151034
678,665,13,7.974733,46.315167,2641293.390,1129447.950,20861,151054
